11111111
1P0E0001
11100C11
1C111111
11111111