


11111000000001011001011010101010110101010111





Prudence est maire de Surete et 
j'imagime au il n y a rien a parser ici



parcontr

gpeur desleaks
