1111111
1000001

1ECP001
1111111