11111111111111111111111111111111111111111111111111111111111
11111111111111111111111100000000000000000000000111111111111
11111111111111111110000000000000000000000000000000000000001
10000000000000000000000000000000000000000E00000000000000001
10000000000000000CCCC00000000000000000000000000000000000001
10000000000000000000000000000000000000000000000000000000001
10000000111111111111111111111111111111111111111110000000001
10000000001111111111111111111111111111111111111111110000001
10000000000000000011111111111111111111111111111111111110001
11111111111111111111111111111111111111111111111111111111111
