1111111
100CEP1
1000001
11111111