111111
100001
1PEC11
1000K1
111111