11111111
10000001
1PPCE001
11111111