111111111111111111
100011000011110001
100010000001100001
10P000000000000001
100000000000000001
1111001C0010001101
111110111100000001
1100000E1100011101
100000001000000001
100000110000110011
111111111111111111
