111111111111111111
100011000011110001
100010000001100001
100000000000000001
100000000000000001
111100100010001101
111111111111111111
