1111111111111111111111111111111111111111111111111111111111111111111111111111111111111111111111111111111111111111111111111111111111111111111111111111111111111111111111111111111111111111111
1000000000000000000000000000000000000000000000111111111111000000000000000000000000000000000000000000000000000000000000000000000000000000000000000000000000000000000000000000000000000000001
1010000000000101111111111111111111111111111111101111111111111111011111111111000000000000000000000000000000000000000000000000000000000000000000000000000000000000000000000000000000000000001
1000000000000000000000000000000000000000000000000000000000000000000000000010000000000000000000000000000000000000000000000000000000E00000000000000000000000011111111111111111111111111111111
1111111111111000000000000000000000001111111111111110000000000CCC0000000000000000000001111111111P1111111111111111110000000000000000000000000000000000000111111111111111111111111111111111111
11111111000000000000000000000000000000111111100000000000CCC00000000000000000000000000000000011111111111111111111111111111111111111111111111111111100000000000000000000000000000000000000001
1111111111111111111111111111111111111111111111111111111111111111111111111111111111111111111111111111111111111111111111111111111111111111111111111111111111111111111111111111111111111111111
