11111111
10000001
10000001
10000001
10000001
1CC00001
1CCC0001
11100001
11000001
10000101
10000011
10000001
10000001
10000001
10000001
1CC00001
1CCC0001
11100001
11000001
10000101
10000011
10000001
10000001
10000001
10000001
1CC00001
1CCC0001
11100001
11000001
10000101
10000011
10000001
100P0001
10000001
10000001
1CC00001
1CCC0001
11100001
11000001
10000001
10000001
10000001
10000001
1CC00001
1CCC0001
11100001
11000001
10000101
10000011
10000001
10E00001
10000001
10000001
10000001
1CC00001
1CCC0001
11100001
11000001
10000101
10000011
10000001
10000001
10000001
10000001
10000001
10000001
10000001
10000001
10000001
10000001
10000001
10000001
10000001
10000001
10000001
10000001
11111111
