11111111111
10000000001
10011100101
1E01C0001P1
10011100101
1000C000001
11111111111
