11111111111
10000000101
11111101111
1E00C0P1101
10001100101
10000000101
11111111111
