11111111111
1C000000101
11111100011
1E00P101001
10101100101
10000001C01
11111111111