11111111111
10C0000C001
10011100101
1EC1C0001P1
10011100101
1C00C000001
11111111111
