1111111111111111111111111
1PCCCCCCC1CC1CCCCCCCC1CC1
1C11111C1CC1C1C1C1C1CC1C1
1CCCCCC11C1CCC1C1CC11CCC1
1C1111CC1CC1C1CCC1CCC1CC1
1CCC1C1CCC1ECC1CC1C1C11C1
1C111C111CC1CCCC1CCC1C1C1
1CCCCCCCC1CCCC1C1CC1CC1C1
11CC111CCC111111CC1CC1CC1
1CC1CCCC1CCCCCCCC1CC1C1C1
1C1C1111C111111111C1CCC11
1CCCCCCCCCCCCCCCCCCCC1CC1
1111111111111111111111111